__1_27_8_
83___6_2_
__68___9_
7___5___9
6_____1_8
__26_3__7
_59_6____
_6_28____
___7__54_
