2__453_8_
______4_3
5____612_
_______6_
___89___1
_12_6___7
_____26__
___9___4_
____7___8
