___9_2___
89_______
______4_7
_4__6__3_
_125_9___
___2___1_
6_1___8_5
3_5______
___67____
