__7_34__1
_4_____76
___2___5_
__6__14__
_______19
_9_75_2__
3___8____
__2___1_5
_1_47_6__
