91_D_E__8_C4____
_____F_B___5G___
__7_8G____E___9_
C____15__3_____6
___5E__2___C7_FB
3_F7__C__A6_95__
2__6__B_19___4_C
__G_1_D5_B7_A_2E
G__4__9__73B6__A
E6_2___FD5__4G__
F__3C4_G______D9
__9____EC_____B7
8_4_5____F___A_2
5D___A_____GB___
6___3B_7__9__8__
_____C__6_A2____
